{
    "width": 21,
    "height": 12,
    "scale": 50,
    "start": [0,3,0],
    "layout": [
        ["O", "O", "O", "O", "O", "O", "O", "O", "O", "O", "O", "O", "O", "O", "O", "O", "O", "O", "O", "O", "O"],
        ["O", ".", ".", ".", ".", ".", ".", ".", ".", ".", ".", ".", ".", ".", ".", ".", ".", ".", ".", ".", "O"],
        [".", ".", ".", ".", ".", ".", ".", ".", ".", ".", ".", ".", ".", ".", ".", ".", ".", ".", ".", ".", "O"],
        [".", ".", ".", "L", ".", ".", ".", ".", "O", ".", ".", ".", "O", ".", ".", ".", "O", ".", ".", ".", "O"],
        [".", ".", ".", ".", ".", ".", ".", ".", "O", ".", ".", ".", "O", ".", ".", ".", "O", ".", ".", ".", "O"],
        ["O", ".", ".", ".", ".", ".", ".", ".", "O", ".", ".", ".", "O", ".", "D", ".", "O", ".", ".", ".", "O"],
        ["O", "O", "O", "O", "O", ".", ".", ".", "O", ".", "R", ".", "O", ".", ".", ".", "O", ".", ".", ".", "O"],
        ["O", ".", ".", ".", ".", ".", ".", ".", "O", ".", ".", ".", "O", ".", ".", ".", "O", ".", ".", ".", "O"],
        ["O", ".", "U", ".", "O", ".", ".", ".", "O", ".", ".", ".", "O", ".", ".", ".", "O", ".", ".", ".", "O"],
        ["O", ".", ".", ".", "O", ".", ".", ".", ".", ".", ".", ".", ".", ".", ".", "U", ".", ".", ".", ".", "O"],
        ["O", ".", ".", ".", "O", ".", ".", ".", ".", ".", ".", ".", ".", ".", ".", ".", ".", ".", ".", ".", "O"],
        ["O", "O", "O", "O", "O", "O", "O", "O", "O", "O", "O", "O", "O", "O", "O", "O", "O", "O", "O", "O", "O"]
    ]
}
